#########
#-------#
#-##----#
#--###--#
#---#---#
#--###--#
#----#--#
#-------#
#########