#########
#-------#
#-------#
#--###--#
#---#---#
#--###--#
#-------#
#-------#
#########